#
# 0 D room1.txt 0
#
WWWW0WWWWW
W        W
W  S     W
WWWWW    W
W   W    W
W   W  WWW
W  h     W
W     s  W
W     f  W
WWWWWWWWWW
